1111111111111
10010C00000C1
1000011101001
1000011101001
1000011101001
1P0011E00C011
1111111111111